******************************
*                            *
*                            *
*       *****                *
*       *   *                *
*       *   *        ** *    *
*       *****        *       *
*                       *    *
*        ***         ****    *
*                            *
*        ***                 *
******************************
